11111111111111111
10100000000000001
10001111101111111
10101000101000101
10101010101010101
10101010101010101
10100010100010101
10111111111110001
10001000000010111
10101110111110101
10100010110000101
10110000100110001
11111111111111111